Letter	Romanized
ੳ	oora
ਅ	aera
ੲ	iri
ਸ	sassa
ਹ	haha
ਕ	kaka
ਖ	khakha
ਗ	gaga
ਘ	ghagha
ਙ	ngana
ਚ	chacha
ਛ	chhachha
ਜ	jajja
ਝ	jhajha		
ਞ	njanja
ਟ	tainka
ਠ	tata
ਡ	dadda
ਢ	dhadha
ਣ	nana
ਤ	tatha
ਥ	thatha
ਦ	dada
ਧ	tdhadha
ਨ	nanna
ਪ	papa
ਫ	phapha
ਬ	baba
ਭ	bhabha
ਮ	mama
ਯ	yaya
ਰ	rara
ਲ	lala
ਵ	wawa
ੜ	rara
